"filename", "language", "TypeScript", "comment", "blank", "total"
"c:\Users\janit\Documents\kudos-craft\backend\src\auth\auth.module.ts", "TypeScript", 34, 0, 2, 36
"c:\Users\janit\Documents\kudos-craft\backend\src\auth\controllers\auth.controller.spec.ts", "TypeScript", 14, 0, 5, 19
"c:\Users\janit\Documents\kudos-craft\backend\src\auth\controllers\auth.controller.ts", "TypeScript", 37, 0, 5, 42
"c:\Users\janit\Documents\kudos-craft\backend\src\auth\decorators\public.decorator.ts", "TypeScript", 2, 0, 2, 4
"c:\Users\janit\Documents\kudos-craft\backend\src\auth\decorators\user.decorator.ts", "TypeScript", 7, 0, 2, 9
"c:\Users\janit\Documents\kudos-craft\backend\src\auth\dto\sign-in.dto.ts", "TypeScript", 11, 0, 3, 14
"c:\Users\janit\Documents\kudos-craft\backend\src\auth\dto\sign-up.dto.ts", "TypeScript", 23, 0, 5, 28
"c:\Users\janit\Documents\kudos-craft\backend\src\auth\guards\jwt.guard.ts", "TypeScript", 20, 0, 2, 22
"c:\Users\janit\Documents\kudos-craft\backend\src\auth\guards\local.auth.guard.ts", "TypeScript", 24, 0, 4, 28
"c:\Users\janit\Documents\kudos-craft\backend\src\auth\services\auth.service.spec.ts", "TypeScript", 14, 0, 5, 19
"c:\Users\janit\Documents\kudos-craft\backend\src\auth\services\auth.service.ts", "TypeScript", 138, 1, 12, 151
"c:\Users\janit\Documents\kudos-craft\backend\src\auth\services\strategies\jwt.strategy.ts", "TypeScript", 17, 0, 3, 20
"c:\Users\janit\Documents\kudos-craft\backend\src\auth\services\strategies\local.strategy.ts", "TypeScript", 23, 0, 3, 26
"Total", "-", 364, 1, 53, 418